WWWWWWWWWWWWWWWWWWWWWWWWWWWWWWWWWWWWWW
W                                    W
W  P                                 W
W                     W              W
W  WWWWWWWWW          W              W
W                     W              W
W                                    W
W             WWWWWWWWW        W     W
W                       P      W     W
W                              W     W
W                              W     W
W        WWWWWWWWWW            W     W
W                       W            W
W                       W            W
W                       W            W
W                W      W            W
W                W                   W
W                                    W
W                                    W
WWWWWWWWWWWWWWWWWWWWWWWWWWWWWWWWWWWWWW
