  WW     W    W  WW        W  W W WW
       W  W WW           W W W W  WW
   W         WP WW       WP   W     
        W   W   W     W   WW        
           W  W W  W    WWWWW   W  W
W   W    W    WW       W W      W   
W     W  WW  W                  WWWW
        W      W      W    W   W W  
 WWWW W W   W   W         W       W 
            WW W W              W   
   W                     WW     W   
   W W W W W      W        W  W W   
   W  W       W   W W  W  W   W   W 
W           W W  W        WW   W W  
  W              W W          W     
 W     W  W     W W WW      W    W  
WW  W         W   W W   W     W     
     W   W  W       WW WW         W 
W                           W    WW 
    W     W W     W     W WW W     W
