 WWWW    W     W    W    W W     W  
   W W         W            W    WW 
       W W W W    WW   W    W W  W  
W   WW   WW        W W    W    W   W
   WW               W               
    W        W          W       W   
    W      W WW  WW  W   WWW   WW W 
     W                     W   W    
   W W          W  PW       W W  W  
 WW   WW       P       W           W
                W   W WW        W  W
    W  W W W            W       W W 
 W W   WW            W  W    W   W W
 W  W   W        W  W      W        
       W W W     W   WWW  W  WW    W
    WW      W         W W          W
  WW                    W    WW  W  
W W   W    W W   W     W  W W  W WW 
   W   WW       W                WWW
    W  W       W  W W      W       W
