           WW       W W     W WW   W
 W   P     W  WW    WW  W           
  P    W  W  W        W  W W  W     
       W                     W  W   
        WW W    W     W   WW  WWW W 
    W   WW  W       W  W     W      
           W WW WW     W     W WW   
         W  W W   W W  WW       W   
    W     WWWWW  W     W    WW      
         WWW   W   W  W     W    W  
W      W WW W       WW W    W   WW  
 W W            W  W   W           W
        W W W    W    W      W   WW 
      W    W  W   W      W   W  W   
W       WWW                  W     W
   WWW            W    W          W 
       W WW  WWW         W        W 
W    W        W   W  W       WW     
W     W   WW   W W      W           
  W W  WW         W   W  W      W   
