W      W W          WW       W  W   
W   W WW                WW       W  
   W WW     W            W   W W WW 
W W WW            WW    W      W W  
  WW            WW    W    W        
W     W         WW W     W WW     P 
 W  WWW        W  W  P     W    W  W
     W W           WW         W W  W
    WW  W  W   W            W     WW
         W W    W    W  W    W      
      W  W W      W      WW W       
   W W   W   W  W  W   W W  W     W 
W               W      W  W W    WW 
  W              W          W       
         W    W W      WW     W     
W   W   W  W        W   W   WW   W  
  W W W W     W      W     W     W  
           W               W  W WWW 
W  W     W  W        W     W    W   
                    W   W  W W      
